           NO                    ./sprites/rock_wall.xpm
NO aklsdmkasdm
NO aklsdmkasdm
NO aklsdmkasdm
NO aklsdmkasdm
NO aklsdmkasdm
NO aklsdmkasdm
NO                                                    aklsdmkasdm



111111111111111111111111111111111111111111111