

              NO ./sprites/wall_512.xpm


SO                        ./sprites/wall2_512.xpm


          WE ./sprites/wall3_512.xpm
                                        EA ./sprites/wall4_512.xpm

    F              0,147,0          






       C  0,0,120          



 
1111111111
1000000001
1000000001
11000001111
  1010000101
11000N00011
1010001011
1110000001
1000000001
1111111111





