C 0,0,120



    NO ./sprites/rock_wall.xpm
SO ./sprites/rock_wall.xpm
F 0,147,0
WE ./sprites/rock_wall.xpm
EA ./sprites/rock_wall.xpm




11111111111111111111111111111111111111111111111111
10000000000000000001100000000110000000011000000001
10000000000000000001100000000110000000011000000001
10000000000000000001100000000110000000011000000001
10000000000000000001100000000110000000011000000001
10000000000000000001100000000110000000011000000001
10000000000000000001100000000000000000011000000001
10000000000000000001100000000000000000011000000001
1000000000000000000000000N000110000000011000000001
10000000011000000000000000000110000000011000000001
10000000011000000000000000000110000000011000000001

10000000011000000001100000000110000000011000000001
10000000011000000001100000000110000000011000000001
10000000011000000000000000000110000000011000000001
10000000011000000000000000000110000000011000000001
10000000011000000001100000000110000000011000000001
10000000011000000001100000000110000000011000000001
10000000011000000000000000000110000000011000000001
10000000011000000000000000000110000000011000000001
10000000011000000001100000000110000000011000000001
10000000011000000001100000000110000000011000000001
10000000011000000000000000000110000000011000000001
10000000011000000000000000000110000000011000000001
10000000011000000001100000000110000000011000000001
10000000011000000001100000000110000000011000000001
11111111111111111111111111111111111111111111111111